
1111111111111111111111111
1000100010001000100010001
1010001010101010101010101
1000100000000000000010001
101011111000E000001010101
1000100010100000100010001
1010101010111010101010101
1000000010000000100010001
1111111111111111111111111